2222222222222222222
2222222222222222222
0000000000000000000
0111111110111111110
0300100010100010030
0111111111111111110
0100101000001010010
0111101110111011110
0000100020200010000
2220102252722010222
0000102002002010000
42221220a2b02212224
0000102000002010000
2220102262822010222
0000102000002010000
0111111110111111110
0100100010100010010
0310111119111110130
0010101000001010100
0111101110111011110
0100000010100000010
0111111111111111110
0000000000000000000